NO Textures/wall_1.png

SO Textures/wall_2.png

WE Textures/wall_3.png

EA Textures/wall_4.png

F 107,24,24
C 52,0,0

        1111111111111111111111111
        1000000001100000000000011
        1011000001110000000000001
        100100000D000000000000001
111111111011000001110000000000001
100000000011000001110111111111111
11110111111111011100100010001
1111D111111111011101010010101
11000000110101011100000010001
10000000000000001100S00010001
10000000000000000001010010001
11000001110101011111D1111000111
11110111 1110101 100000000001
11111111 1111111 111111111111