NO Textures/wall_1.png

SO Textures/wall_2.png

WE Textures/wall_3.png

EA Textures/wall_4.png

F 107,24,24
C 52,0,0

D Textures/Bonus/door.png

1111111111111111111
1S00000000000000001
1001D100000000000001
100001D100000000001
1000000000000000001
1111111111111111111