NO Textures/bruja.png

SO Textures/calabaza.png

WE Textures/fantasmita.png

EA Textures/murcielagos.png

F 220,100,0
C 225,30,0
       XXXXXXXXXXXXXXXXXXXXXXXXXXX
       X1111111111111111111111111X
       X1000000001100000000000011X
       X1011000001110000000000001X
       X1001000000000000000000001X
XXXXXXXX1111111111111111111111111X
X111111111111111111111111111111111X
X111111111011000001110000000000001X
X100000000011000001110111111111111X
X11110111111111011100000010001XXXXXXX
X11110111111111011101010010101X  X111X
X11000000110101011100000010001X  X101X
X10000000000000001100000010001X  X111X
X10000000000000001101010010001X  XXXXX
X1100000111010101111101111N001X
X11110111X1110101X101111010001X
X11111111X1111111X111111111111X
XXXXXXXXXXXXXXXXXXXXXXXXXXXXXXX