NO Textures/wall_1.png

SO Textures/wall_2.png

WE Textures/wall_3.png

EA Textures/wall_4.png

F 95,60,35
C 54,54,54

1111
11111111111
111000100001
11100001001
1000000001
10000100N1
1000001001
1111111111