NO Textures/bruja.png

SO Textures/calabaza.png

WE Textures/fantasmita.png

EA Textures/murcielagos.png

F 167,167,167
C 145,255,243
1111
11111111111
111000100001
11100001001
100N000001
1000000001
1000000001
1111111111