NO Textures/bruja.png

SO Textures/calabaza.png

WE Textures/fantasmita.png

EA Textures/murcielagos.png

F 220,100,0
C 225,30,0

        1111111111111111111111111
        1000000001100000000000011
        1011000001110000000000001
        1001000000000000000000001
        1111111111111111111111111

111111111111111111111111111111111
111111111011000001110000000000001
100000000011000001110111111111111
11110111111111011100000010001
11110111111111011101010010101    111
11000000110101011100000010001    1Z1
10000000000000001100000010001    111
10000000000000001101010010001
1100000111010101111101111N00111
11110111 1110101 101111010001
11111111 1111111 111111101111